2200000000000020212121220000000000000020
2200000000000030313131320000000000000020
2200000000000000000000000000000000000020
2200000000000000000000000000000000000020
2311111112000000000000000000101111111124
1331313132000000000000000000202121212121
2200000000000000000000000000202121212121
3200000000000000000000000000303131313131
0000001011111112000000000000000000000000
0000002021212122000000000000000000000000
1111112421212123111111111111111111111111

image image:tiles
sprite @9,4 sprite:hero (u32)0
position 128 128
sprite @11,5 sprite:ghost (u16)0 (u8:cipher)substitution (u8)4
sprite @9,9 sprite:sleepyhead (u16)0 (u8:cipher)substitution (u8)19
sprite @17,3 sprite:skeleton (u16)0 (u8:cipher)substitution (u8)20
