2200000000000000000000000000000000000020
2200000000000000000000000000000000000020
2200001012000000000000000000000000000020
2200102423120000000000000000000000000020
2200301413320000000000000000000000000020
2200003032000000000000000000000000000020
2200000000000000000000000000101112000020
3200000000000000000000000000303132000030
0000000000000000000000000000000000000000
0000000000000000000000000000000000000000
1111111111111111111111111111111111111111

image image:tiles
sprite @9,4 sprite:hero (u32)0
position 128 128
