2121211331313131313131142121212121212121
2121133200000000000000202113313131313131
2121220000000000000000202122000000000000
2121220000000000000000303132000000000000
3131320000001012000000000000000000101111
0000000000002022000000000000000000202121
0000000000002022000000101112000000202121
0000000000002022000000202122000000202121
1111120000002022000000202122000000202121
2121220005002022000500202122000500202121
2121231115112423111511242123111511242121

image image:tiles
position 126 128
sprite @15,8 sprite:switch (u8:flag)maze_switch_9 (u24)0
sprite @4,8 sprite:switch (u8:flag)maze_switch_7 (u24)0
sprite @9,8 sprite:switch (u8:flag)maze_switch_8 (u24)0
sprite @9,2 sprite:firepot (u32)0
