2121211331313131313131142121212121212121
2121133203030203000401202113313131313131
2121220100020203010303202122020002020400
2121220001010401020201303132040003000001
3131320400041012010203010204010102101111
0100030103032022040204000200020401202121
0204000002022022040402101112030003202121
0402020301002022010003202122000403202121
1111120404022022010003202122000402202121
2121220305032022010501202122030502202121
2121231115112423111511242123111511242121

image image:tiles
position 126 128
sprite @15,8 sprite:switch (u8:flag)maze_switch_9 (u24)0
sprite @4,8 sprite:switch (u8:flag)maze_switch_7 (u24)0
sprite @9,8 sprite:switch (u8:flag)maze_switch_8 (u24)0
sprite @9,2 sprite:firepot (u32)0
