2121212121212121212121212121212121212121
2121212121212121212121212121212121212121
3131313131313131311421212121212121212121
0103010000040302013031313131311421212121
0200030301040000030001010303043031313131
0201030200010404010002040002020000040301
0100030403001012000104010002000402030204
1111120000022022020003101112020204040203
2121220402042022040404202122020104101111
2121220305012022000502202122040504202121
2121231115112423111511242123111511242121

image image:tiles
position 125 128
sprite @15,8 sprite:switch (u8:flag)maze_switch_6 (u24)0
sprite @4,8 sprite:switch (u8:flag)maze_switch_4 (u24)0
sprite @9,8 sprite:switch (u8:flag)maze_switch_5 (u24)0
sprite @8,3 sprite:firepot (u32)0
