1331313131313131313131313131313131313114
2200000000000000000000000000000000000020
3200000000000000000000000000000000000020
0000000000000000000000000000000000000020
0000000000000000000000000000000000000030
0000000000000000000000000000000000000000
0000000000000000000000000000000000000000
1200000000000000000000000000000000000000
2200000000000000000000000000000000000010
2200000000000000000000000000000000000020
2311111111111112000000101111111111111124

image image:tiles
position 125 128 0
