2121212121212121212121212121212121212121
2121212121212121212121212121212121212121
3131313131313131311421212121212121212121
0000000000000000003031313131311421212121
0000000000000000000000000000003031313131
0000000000000000000000000000000000000000
0000000000001012000000000000000000000000
1111120000002022000000101112000000000000
2121220000002022000000202122000000101111
2121220005002022000500202122000500202121
2121231115112423111511242123111511242121

image image:tiles
position 125 128
sprite @15,8 sprite:switch (u8:flag)maze_switch_6 (u24)0
sprite @4,8 sprite:switch (u8:flag)maze_switch_4 (u24)0
sprite @9,8 sprite:switch (u8:flag)maze_switch_5 (u24)0
