2121211331313131311421212121212121212121
2121212200000000002021212121212121212121
2121212200000000003031142113313131313131
2121212200001012000000202122000000000000
1331313200003032000000303132000000000000
2200000000000000000000000000000000000000
2200000000000000000000003300000000000000
2200000000000000000000000000000000101111
2311120000001012000607070807070900202121
2121220005002022001607071807071900202121
2121231115112423111511111111111511242121

image image:tiles
position 124 128
sprite @15,7 sprite:switch (u8:flag)maze_switch_3 (u24)0
sprite @4,8 sprite:switch (u8:flag)maze_switch_1 (u24)0
sprite @9,7 sprite:switch (u8:flag)maze_switch_2 (u24)0
