2121212121211331313131313131313131313114
2121212121133200000000000000000000000020
2121212113320000000000001011111111120020
2121211332000000000000002021212121220020
2121133200000000001012003031311421220020
2121220000000000102422000000002021220020
2121220000000010242123111112002021220020
2121220000001024212121212122003031320020
2121220000002021212121212122000000000020
2121220000002021212121212122000000000020
2121220000002021212121212122000000101124

image image:tiles
position 123 128
