2121212121211331313131313131313131313114
2121212121133200020102000401020403020320
2121212113320401010200011011111111120220
2121211332000000020104012021212121220320
2121133203020100031012003031311421220020
2121220003030104102422020301022021220320
2121220101040410242123111112002021220120
2121220404001024212121212122013031320120
2121220100002021212121212122020003000220
2121220101012021212121212122040004040220
2121220402022021212121212122040002101124

image image:tiles
position 123 128
sprite @7,3 sprite:firepot (u32)0
