1331320000003031142113313132000000303114
2200000000000000202122000000000000000020
2200000000000000202122000000000000000020
2312000000000000202122000000000000000030
2122000000000000202123111111120000000000
1332000010120000202121212121220000000000
2200000030320000202113313114231111111111
2200000000000000202122000030313131313114
2200000000000000202122000000000000000020
2200000000000000202122000000000000000020
2311111200001011242123111112000000101124

image image:tiles
position 123 129
sprite @12,8 sprite:firepot (u32)0
