1331320203043031142113313132030203303114
2203010102040300202122020300040204020320
2201000000030203202122030102030201010420
2312020300000202202122010000030301000130
2122010104040201202123111111120101010403
1332020410120104202121212121220204030401
2202000430320404202113313114231111111111
2201000300010302202122030330313131313114
2204030003020301202122040400020002040220
2203010103040400202122010200020402040320
2311111202041011242123111112030200101124

image image:tiles
position 123 129
sprite @12,8 sprite:firepot (u32)0
