1331313131313132000000303131313131313114
2200000000000000000000000000000000000020
2200000000000000000000000000000000000020
2312000000000000000000000000000000000030
2122000000000000000000000000000000000000
1332000000000000000000000000000000000000
2200000000000000000000000000000000000010
2200000000000000000000000000000000000020
2200000000000000000000000000000000000020
2200000000000000000000000000000000000020
2311111111111112000000101111111111111124

image image:tiles
position 123 129
