2121212125212121212521212121212513313131
1331313135313114212513313131313532000000
2200000045000030313532000000004500000010
3200001011120000004500000010111111111124
0000002021231111111111111124212121212121
0000002021212121212121212121212121212121
1111112421212121212121212113313131313131
2121212121212121133131313132000000000000
2121212121212121220000000000000000000000
2121212121212121220000000000000000000010
2121212121212121220000001011111111111124

image image:tiles
position 124 129
sprite @15,2 sprite:gate (u8:flag)maze_switch_2 (u8)0 (u16)0
sprite @4,2 sprite:gate (u8:flag)maze_switch_1 (u8)1 (u16)0
sprite @9,3 sprite:gate (u8:flag)maze_switch_3 (u8)1 (u16)0
