2121212125212121212521212121212513313131
1331313135313114212513313131313532030101
2201000345040030313532000104024502010110
3204001011120403004501000310111111111124
0000032021231111111111111124212121212121
0001042021212121212121212121212121212121
1111112421212121212121212113313131313131
2121211331142121133131313132040300000101
2121212204202121220304000001000103010202
2121212311242121220402030302040203030010
2121212121212121220400031011111111111124

image image:tiles
position 124 129
sprite @15,2 sprite:gate (u8:flag)maze_switch_2 (u8)0 (u16)0
sprite @4,2 sprite:gate (u8:flag)maze_switch_1 (u8)1 (u16)0
sprite @9,3 sprite:gate (u8:flag)maze_switch_3 (u8)1 (u16)0
sprite @4,8 sprite:firepot (u32)0
