3131313135313114212521212121212521212121
0000000045000020212513313131313531313131
1111111112000030313532000000004500000000
2121212122000000004500000010111111111111
2121212123111111111111111124212121212121
1331313131313131311413313131313131313114
3200000000000000002022000000000000000030
0000000000000000002022000010120000000000
0000000000000000002022000030320000000000
1200000000000000002022000000000000000000
2311120000001011112423111112000000101111

image image:tiles
position 125 129
sprite @15,2 sprite:gate (u8:flag)maze_switch_6 (u8)1 (u16)0
sprite @4,1 sprite:gate (u8:flag)maze_switch_4 (u8)1 (u16)0
sprite @9,3 sprite:gate (u8:flag)maze_switch_5 (u8)0 (u16)0
sprite @5,7 sprite:firepot (u32)0
