2121212125212121212521212121212521212121
3131313135313131142521133131313531313131
0000000045000000303531320000004500000000
1111111111120000004500000000101112000000
2121212121231111111111111111242123111111
2121212113313131313131313131311421212121
3131313132000000000000000000003031313131
0000000000000000000000000000000000000000
0000000000000000000000000000000000000000
0000000000001011111111111112000000000000
1111111111112421212121212123111111111111

image image:tiles
position 126 129
sprite @15,2 sprite:gate (u8:flag)maze_switch_9 (u8)1 (u16)0
sprite @4,2 sprite:gate (u8:flag)maze_switch_7 (u8)0 (u16)0
sprite @9,3 sprite:gate (u8:flag)maze_switch_8 (u8)1 (u16)0
sprite @9,7 sprite:firepot (u32)0
