2121212125212121212521212121212521212121
3131313135313131142521133131313531313131
0100020445030103303531320404044502040000
1111111111120103014503000103101112040204
2121212121231111111111111111242123111111
2121212113313131313131313131311421212121
3131313132010102000001030002023031313131
0103020302040404040304040304040403040003
0101010100010002040302020003020402040303
0403030101001011111111111112030000040002
1111111111112421212121212123111111111111

image image:tiles
position 126 129
sprite @15,2 sprite:gate (u8:flag)maze_switch_9 (u8)1 (u16)0
sprite @4,2 sprite:gate (u8:flag)maze_switch_7 (u8)0 (u16)0
sprite @9,3 sprite:gate (u8:flag)maze_switch_8 (u8)1 (u16)0
sprite @9,7 sprite:firepot (u32)0
