1331313204013031141331320301032021212121
3202010003040402202202030204002021212121
0201020203020002202202040303042021212121
0303010302030104202204000302002021212121
1201030203000201202200000002033014212121
2311111111111111242204020002000220212121
3131313131313131313202040400010020212121
0302000103000102030201003304010420212121
0303040202010103040003020400020020212121
0404010002010300010404040302040220212121
1111111111111111111111111201020420212121

image image:tiles
position 127 129
sprite @15,5 sprite:firepot (u32)0
