1331313200003031141331320000002021212121
3200000000000000202200000000002021212121
0000000000000000202200000000002021212121
0000000000000000202200000000002021212121
1200000000000000202200000000003014212121
2311111111111111242200000000000020212121
3131313131313131313200000000000020212121
0000000000000000000000003300000020212121
0000000000000000000000000000000020212121
0000000000000000000000000000000020212121
1111111111111111111111111200000020212121

image image:tiles
position 127 129
