1331313200003031313131320000003031313114
2200000000000000000000000000000000000020
2200000000000000000000000000000000000020
2200000000000000000000000000000000000020
3200000033000000000000330000000000000020
0000003334340010120010120010120000000020
0000000034000030320030320030320000000020
1200000000000000000000000000000000000020
2200000000000000000000000000000000000020
2200000000000000000000000000000000000020
2311111111111111111200000010111111111124

image image:tiles
position 127 129
