2121212121212121211331313200000020212121
2121212121212121133200000000000020212121
2121212121212113320000001011111124212121
3131311421211332000000003014212121212121
0000002021133200000000000030142121212121
0000003031320000000033000000301421212121
0000000033000000003400330000003014212121
1112000000001012330034003400000020212121
2123111111112422000000000000000020212121
2121212121212122000000000000000020212121
2121212121212122000000101111111124212121

image image:tiles
position 127 130
sprite @10,6 sprite:firepot (u32)0
