2121212121212121211331313201020420212121
2121212121212121133202010401020420212121
2121212121212113320404041011111124212121
3131311421211332000303033014212121212121
0404022021133200020204000330142121212121
0200043031320004040133010404301421212121
0202010134010303043401330303013014212121
1112040004041012340434003402040220212121
2123111111112422000201020403020320212121
2121212121212122000100000301040220212121
2121212121212122010201101111111124212121

image image:tiles
position 127 130
sprite @10,6 sprite:firepot (u32)0
