2121212121212121220000202121212121212121
3131313114212121220000202121211331313131
0000000020211331320000303114212200000000
1111120020212200000000000020212200101111
2121220020212200000000000020212200202121
1331320030313200000000000030313200303114
2200000000000000001012000000000000000020
2200000000000000102423120000000000000020
2200000000000000303131320000000000000020
2200000000000000000000000000000000000020
2200000000000000000000000000000000000020

image image:tiles
position 128 127 0
