2121133131313132040000303131313131142121
2113320300020102020104000301010000301421
1332000002000404000200040100030300013014
2202020302101111111111111111120001020220
2200020310242113313131313114231201030420
2203000230142122000103030320212201010020
2202030102301423111111111124133200030020
2200030203023031313131313131320201020420
2312020301020300040100010201010401021024
2123120103020304030300020301020004102421
2121231111111111120303101111111111242121

image image:tiles
position 127 131
sprite @12,5 sprite:firepot (u32)0
sprite @8,5 sprite:firepot (u32)0
