1331313131313132000000303131313131313114
2200000000000000000000000000000000000020
2200000000000000000000000000000000000020
2200000000000000000000000000000000000020
3200000000000000000000000000000000000020
0000000000000000000000000000000000000020
0000000000000000000000000000000000000020
0000000000000000000000000000000000000020
1200000000000000000000000000000000000020
2200000000000000000000000000000000000020
2311111111111111120000101111111111111124

image image:tiles
position 127 131
