2121133131313132000000303131313131142121
2113320000000000000000000000000000301421
1332000000000000000000000000000000003014
2200000000101111111111111111120000000020
2200000010242113313131313114231200000020
2200000030142122000000000020212200000020
2200000000301423111111111124133200000020
2200000000003031313131313131320000000020
2312000000000000000000000000000000001024
2123120000000000000000000000000000102421
2121231111111111120000101111111111242121

image image:tiles
position 127 131
