3131313114212121220000303131313131313114
0000000020212121220000000000000000000020
0000000020212121220000000000000000000020
1200000020212121231111111111111112000020
2200000030313131313131311413311422000020
2200000000000000000000002022002022000020
2200000000000000000000002023112422000020
3200001011111111120000003031313132000020
0000002021212121220000000000000000000020
0000002021212121220000000000000000000020
1111112421212121231111111111111111111124

image image:tiles
position 127 132
sprite @14,5 sprite:firepot (u32)0
