3131313114212121220201303131313131313114
0201000320212121220303010204020404000220
0400040120212121220104040101020001000420
1203000220212121231111111111111112030120
2200020130313131313131311413311422000120
2200040104000104010103002022002022020120
2204010404010103040102022023112422020020
3201041011111111120200023031313132040020
0203032021212121220003020301020300000420
0103022021212121220203040401020303010220
1111112421212121231111111111111111111124

image image:tiles
position 127 132
sprite @14,5 sprite:firepot (u32)0
