1331313200002021212121212122000000301421
2200000000002021212121212122000000002021
2200000000002021212121212122000000002021
2200000010112421212121212123111200002021
2200000020212121212121133131313200002021
2200000030313131313114220000000000002021
2200000000000000000020220000000000002021
2200000000000000000020220000001011112421
2311111111111200000020220000002021212121
2121212121212200000020220000002021212121
2121212121212200000020220000002021212121

image image:tiles
position 123 130
sprite @2,4 sprite:firepot (u32)0
