1331313202012021212121212122010201301421
2203010103002021212121212122010300012021
2202030101022021212121212122020103042021
2203010410112421212121212123111204022021
2201020120212121212121133131313204042021
2203020230313131313114220102020001012021
2203040301010003020120220103000003042021
2204040404010102000420220401031011112421
2311111111111200000220220302012021212121
2121212121212201020120220202002021212121
2121212121212202040220220404042021212121

image image:tiles
position 123 130
sprite @2,4 sprite:firepot (u32)0
