1331313131313200000020220000003031313114
2200000000000000000020220000000000000020
2200000000000000000020220000000000000020
2200001011111111111124231111111112000020
2200002021212121212121212121212122000020
2200003031313131313131313114212122000020
2200000000000000000000000020212122000020
2200340034003300340033000020133132000020
2234003400330034003300330020220000000020
2200000000000000000000000020220000000020
2312000010111111111111111124220000101124

image image:tiles
position 123 131
