1331313131313200010220220103003031313114
2201030001000402010220220002010200010120
2203010002000002040020220101040103000320
2203041011111111111124231111111112000420
2203022021212121212121212121212122020020
2203003031313131313131313114212122040020
2203040304000100010401000020212122040220
2203330234030303340233020420133132040220
2234043400330434013301330420220200040220
2203040002010203040300020020220403010120
2312020410111111111111111124220103101124

image image:tiles
position 123 131
sprite @6,7 sprite:firepot (u32)0
