2122000020212113313131313131320000202121
2122000020212122000000000000000000202121
2122000030311422000000000000000000202121
2122000000002022000010111111111111242121
2122000000002022000030311413313131313131
2123111200002022000000002022000000000000
2121212200002023111200002022000000000000
2121212200003031313200003032000010111111
2121212200000000000000000000000020212121
2121212200000000000000000000000020212121
2121212311111111111111111111111124212121

image image:tiles
position 123 132
