2122030320212113313131313131320204202121
2122010020212122020402030002010401202121
2122030130311422020404030400040103202121
2122030300002022030210111111111111242121
2122020401012022020330311413313131313131
2123111203002022040404002022040203040301
2121212204012023111200012022040104040403
2121212202003031313201013032040110111111
2121212202040302000403010101020020212121
2121212204000203030001030302040220212121
2121212311111111111111111111111124212121

image image:tiles
position 123 132
sprite @5,3 sprite:firepot (u32)0
