1331313131311421212121133131313131313114
2200000000003031313131320000000000000020
2200000000000000000000000000101200000020
2200001012000000000000000010242312000020
3200003032000000330033000030141332000030
0000000000340000000000000000303200000000
0000001012000000340033000000000000000000
1200003032000000000000000000000000001011
2200000000000000000000000010120000002021
2200000000000000001011111124231111112421
2311111111111111112421212121212121212121

image image:tiles
position 124 132
sprite @9,5 sprite:firepot (u32)0
