1331313131311421212121133131313131313114
2204000001043031313131320103040204000320
2204040101040404040203030400101200020120
2201041012030101000402020310242312010220
3203023032040304330033030430141332020030
0202000400340000010304000302303202010300
0301031012030204330233010204030001010100
1203003032040001020304030401000300011011
2200020004020200000202010110120001042021
2204030102010200001011111124231111112421
2311111111111111112421212121212121212121

image image:tiles
position 124 132
sprite @9,5 sprite:firepot (u32)0
