1331313131313131320000003031313131313114
2200000000000000000000000000000000000020
2200000000000000000000000000000000000020
3200000000000000000000000000000000000020
0000000000000000000000000000000000000030
0000000000000000000000000000000000000000
0000000000000000000000000000000000000000
1200000000000000000000000000000000000010
2200000000000000000000000000000000000020
2200000000000000000000000000000000000020
2311111111111111111111111111111111111124

image image:tiles
position 124 132 0
