2121220103003031313131142121133131313131
2121220303020203000202201331320203040102
2121220000030402040002303201040304030400
2121231111111111111203040101010103000404
3131313131313131142202040110111111111111
0200030002020102202203020420133131313131
0401340433033303202311111124220300040300
1203010404020004303131313131320000020200
2203340334040400010001000101020201040110
2204000004010403000103030304000401010220
2311111111111111111111111111111111111124

image image:tiles
position 125 132
sprite @6,8 sprite:firepot (u32)0
