2121220000003031313131142121133131313131
2121220000000000000000201331320000000000
2121220000000000000000303200000000000000
2121231111111111111200000000000000000000
3131313131313131142200000010111111111111
0000000000000000202200000020133131313131
0000340034003300202311111124220000000000
1200000000000000303131313131320000000000
2200340034000000000000000000000000000010
2200000000000000000000000000000000000020
2311111111111111111111111111111111111124

image image:tiles
position 125 132
sprite @6,8 sprite:firepot (u32)0
