3131313131313131313114212113313131313131
0002020203040403020330142122010303040102
0301020000020401030204202122020402010000
0200010110111112040100303132041011111111
1111111124212123111204040301002021212121
3131313131313131142203000100042021212121
0102000300030204202311111111112421212121
0304010001030302303131313131313131313131
1111111111120003040402000201010404020103
2121212121220000000000030002020104030002
2121212121231111111111111111111111111111

image image:tiles
position 126 132
sprite @10,5 sprite:firepot (u32)0
