3131313131313131313114212113313131313131
0000000000000000000030142122000000000000
0000000000000000000000202122000000000000
0000000010111112000000303132001011111111
1111111124212123111200000000002021212121
3131313131313131142200000000002021212121
0000000000000000202311111111112421212121
0000000000000000303131313131313131313131
1111111111120000000000000000000000000000
2121212121220000000000000000000000000000
2121212121231111111111111111111111111111

image image:tiles
position 126 132
