1331320301022021212121220201003031142121
3202020204002021133114220302020004301421
0401040401033014220220220400010100003014
0302020401040320220320231112030304030420
1111111202020120220120212123120004040320
2121212311111124220320212121220202020120
3131313131313114231124133131320200020220
0100040002010030313131320300040201030020
0200010002000101040002040404010303021024
1111111112030402040302020203040410112421
2121212123111111111111111111111124212121

image image:tiles
position 126 131
sprite @9,5 sprite:firepot (u32)0
sprite @9,2 sprite:firepot (u32)0
