1331320000002021212121220000003031142121
3200000000002021133114220000000000301421
0000000000003014220020220000000000003014
0000000000000020220020231112000000000020
1111111200000020220020212123120000000020
2121212311111124220020212121220000000020
3131313131313114231124133131320000000020
0000000000000030313131320000000000000020
0000000000000000000000000000000000001024
1111111112000000000000000000000010112421
2121212123111111111111111111111124212121

image image:tiles
position 126 131
