2121212121211331142121133131313131313114
2121212121212201202113320100040101020230
2121212121212311241332040002020203030004
2113313131313114212203030201010100020000
1332030402040330142204010204101111111111
2200000302040204202200040401202121212121
2203010304010303202201010301303131313131
2202030401010200202204030300000203040402
2312010302000402202312020400010100040203
2123120002020210242123120004040301040410
2121220200001024212121231111111111111124

image image:tiles
position 125 131
sprite @4,5 sprite:skeleton (u16)0 (u8:cipher)substitution (u8)11
sprite @7,1 sprite:firepot (u32)0
