2121212121211331142121133131313131313114
2121212121212200202113320000000000000030
2121212121212311241332000000000000000000
2113313131313114212200000000000000000000
1332000000000030142200000000101111111111
2200000000000000202200000000202121212121
2200000000000000202200000000303131313131
2200000000000000202200000000000000000000
2312000000000000202312000000000000000000
2123120000000010242123120000000000000010
2121220000001024212121231111111111111124

image image:tiles
position 125 131
sprite @4,5 sprite:skeleton (u16)0 (u8:cipher)substitution (u8)11
sprite @7,1 sprite:firepot (u32)0
