1331313131313131313131313131313131313114
2200000000000000000000000000000000000020
2200003300000000000033000000000000000020
2200343434001012001012001012000000000020
2200003400003032003032003032000000000020
2200000000000000000000000000000000000020
2200000000000000000000000000000000000020
2200000000000000000000000000000000000020
2200000000000000000000000000000000000020
2200000000000000000000000000000000000020
2311111111111111120000101111111111111124

image image:tiles
position 128 126
