2121211331313131313204030130313114212121
2113313204020104020102010103000330311421
2122010202020004020400010303000202012021
1332030003020002030304020204040102013014
2201020103030302000402000101010003040320
2201040102000102010201000304010301040420
2200010402030404030102030102010200040420
2312030002040201040303030401030002041024
2122020000330033043303340334010401012021
2123111202020300030101010201001011112421
2121212311111111111111111111112421212121

image image:tiles
position 124 131
sprite @16,4 sprite:firepot (u32)0
sprite @3,4 sprite:firepot (u32)0
sprite @3,6 sprite:firepot (u32)0
sprite @16,6 sprite:firepot (u32)0
