1331313131313131313200000030313131313114
2200000000000000000000000000000000000020
2200000000000000000000000000000000000020
3200000000000000000000000000000000000020
0000000000000000000000000000000000000030
0000000000000000000000000000000000000000
0000000000000000000000000000000000000000
1200000000000000000000000000000000000000
2200000000000000000000000000000000000010
2200000000000000000000000000000000000020
2311111111111111120000001011111111111124

image image:tiles
position 124 131 0
