2121211331313131313200000030313114212121
2113313200000000000000000000000030311421
2122000000000000000000000000000000002021
1332000000000000000000000000000000003014
2200000000000000000000000000000000000020
2200000000000000000000000000000000000020
2200000000000000000000000000000000000020
2312000000000000000000000000000000001024
2122000000340033003400330034000000002021
2123111200000000000000000000001011112421
2121212311111111111111111111112421212121

image image:tiles
position 124 131
