1331313131313131320000002021212121212121
2200000000000000000000002021212121212121
2200000000000000000000002021212121212121
2200001011111111111111112421212121212121
2200003031313131313131313131313131142121
2200000000000000000000000000000000202121
2200000000000000000000000000000000202121
2311111111120000000034003300000000202121
2121212121220000000000000000000000202121
2121212121220000000000000000000000202121
2121212121231111111200000010111111242121

image image:tiles
position 124 130
sprite @14,7 sprite:firepot (u32)0
