1331313131313131320301042021212121212121
2204040102020402040104042021212121212121
2200020103000302040304032021212121212121
2202021011111111111111112421212121212121
2202043031313131313131313131313131142121
2201020403000203030104030200000303202121
2201000101040101010104040001030200202121
2311111111120404030333013403020403202121
2121212121220204030000000404010302202121
2121212121220200010402030403020303202121
2121212121231111111202010010111111242121

image image:tiles
position 124 130
sprite @14,7 sprite:firepot (u32)0
