2121220302033014212121133132030001202121
2121220202030130142121220303010303202121
2121220303010403202121220400041011242121
2121220304010004303131320004013031313131
2113320201030301010201010401030404040303
2122010301101202000200020103030201010203
2122001011242204101111111111120304030402
2122022021212202202121212121231111111111
2122023031313203202121212121212121212121
2122000004030103202121212121212121212121
2123111111111111242121212121212121212121

image image:tiles
position 125 130
sprite @7,2 sprite:firepot (u32)0
