2121220000003014212121133132000000202121
2121220000000030142121220000000000202121
2121220000000000202121220000001011242121
2121220000000000303131320000003031313131
2113320000000000000000000000000000000000
2122000000101200000000000000000000000000
2122001011242200101111111111120000000000
2122002021212200202121212121231111111111
2122003031313200202121212121212121212121
2122000000000000202121212121212121212121
2123111111111111242121212121212121212121

image image:tiles
position 125 130
