2121212121212121212121211331313131313114
2121212121212121212121133200000000000020
2121212121212121212113320000000000000020
3131313131142121211332000000000000000030
0000000000301421212200000000340000000000
0000000000002021212200000033003300000000
0000101200003014212200000000340000000000
1200202312000020212200000000000000000010
2200303132000020212312000000000000000020
2200000000000020212122000000000000000020
2311120000001024212123120000001011111124

image image:tiles
position 126 130
sprite @14,5 sprite:firepot (u32)0
