2121212121212121212121211331313131313114
2121212121212121212121133200020001030320
2121212121212121212113320401000300010020
3131313131142121211332010201030202040030
0103040104301421212204010304330001010404
0404000300042021212204020133003400040300
0401101201033014212202040301340003030003
1200202312000020212201040004030302020110
2204303132020020212312030102030004040320
2204030100020020212122040202020401040120
2311120004021024212123120203041011111124

image image:tiles
position 126 130
sprite @14,5 sprite:firepot (u32)0
