1331313131313131313131320030313131313114
2200000000000000000000000000000000000020
2200000000000000000000000000000000000020
2200000000000000000000000000000000000020
2200000000000000000000000000000000000020
2200000000000000000000000000000000000020
2200000000000000000000000000000000000020
2200000000000000000000000000000000000020
2200000000000000000000000000000000000020
2200000000000000000000000000000000000020
2311111111111111111111111111111111111124

image image:tiles
position 128 129
sprite @2,8 sprite:switch (u8:flag)maze_exit (u24)0
sprite @2,2 sprite:switch (u8:flag)vulture_gone (u24)0
sprite @8,2 sprite:switch (u8:flag)eyeball_gone (u24)0
sprite @17,2 sprite:switch (u8:flag)penguin_gone (u24)0
