2122000000303131142121212121212121212121
2122000000000000202121212121211331313131
2122000000000000202121212121212200000000
2123111112000000303131313131313200000010
2121212122000000000000000000000000000020
2121212122000000000000000000000000000020
2121212122000010120000000000001012000020
2121212122000030320000000000003032000020
2121212122000000000000000000000000000020
2121212122000000000000000000000000000020
2121212123111111111111111111111111111124

image image:tiles
position 127 127
sprite @12,5 sprite:skeleton (u16)0 (u8:cipher)vigenere (u8)17
