1332000000303131313131313131313131313114
2200000000000000000000000000000000000030
2200000000000000000000000000000000000000
2200000000000000000000000000000000000010
2200000000000000000000000000000000000020
2200000000000000000000000000000000000020
2200000000000000000000000000000000000020
2200000000000000000000000000000000000020
2200000000000000000000000000000000000020
2200000000000000000000000000000000000020
2311111111111111111111111111111111111124

image image:tiles
position 127 127 0
