2122030302303131142121212121212121212121
2122020203000404202121212121211331313131
2122000202040200202121212121212203020302
2123111112020404303131313131313200040110
2121212122000403020203000004030004010420
2121212122020400030102000103040204000020
2121212122000110120002040401001012030120
2121212122010130320004000102003032000420
2121212122030000040203040103020400000320
2121212122010002040101030402020103020420
2121212123111111111111111111111111111124

image image:tiles
position 127 127
sprite @12,5 sprite:skeleton (u16)0 (u8:cipher)vigenere (u8)17
sprite @11,7 sprite:firepot (u32)0
