1331313131313131313131313131313131313114
2200000000000000000000000000000000000020
2200003300000000000034000000000000000020
2200333434001012001012001012000000000020
2200003400003032003032003032000000000020
2200000000000000000000000000000000000020
2200000000000000000000000000000000000020
2200000000000000000000000000000000000020
2200000000000000000000000000000000000020
2200000000000000000000000000000000000020
2312000000101111111111111111111111111124

image image:tiles
position 127 126
