2113313131142121212121212121212121212121
1332000000301421212121212121212121212121
2200000000002021212121212121212121212121
2200000000002021212121212121212121212121
2200000000002021212121212121212121212121
2312000000102421212121212121212121212121
2122000000202121212121212121212121212121
2122000000202121212121212121212121212121
2122000000202121212121212121212121212121
2122000000202121212121212121212121212121
2122000000202121212121212121212121212121

image image:tiles
position 127 126
sprite @3,3 sprite:sign (u16)0 (u8:cipher)vigenere (u8)13
