2113313131142121212121212121212121212121
1332020404301421212121212121212121212121
2204040401032021212121212121212121212121
2201020203022021212121212121212121212121
2204030104012021212121212121212121212121
2312000401102421212121212121212121212121
2122030103202121212121212121212121212121
2122040302202121212121212121212121212121
2122000301202121212121212121212121212121
2122000101202121212121212121212121212121
2122040203202121212121212121212121212121

image image:tiles
position 127 126
sprite @3,3 sprite:sign (u16)0 (u8:cipher)vigenere (u8)13
