2121212121212121212113313131313131311421
2121212121212121211332000000000000003014
2121212121212121212200000000000000000020
2121212121212121212200000000000000000020
2121212121212121212200000000000000000020
2121212121212121212200000000000000000020
2121212121212121212312000000000000001024
2121212121212121212123120000000000102421
2121212121212121212121231200000010242121
2121212121212121212121212200000020212121
2121212121212121212121212200000020212121

image image:tiles
position 129 126
sprite @14,3 sprite:sign (u16)0 (u8:cipher)playfair (u8)14
