1331313131313131313131313131313131313114
2200000000000000000000000000000000000020
2200003400000000000034000000000000000020
2200333333001012001012001012000000000020
2200003300003032003032003032000000000020
2200000000000000000000000000000000000020
2200000000000000000000000000000000000020
2200000000000000000000000000000000000020
2200000000000000000000000000000000000020
2200000000000000000000000000000000000020
2311111111111111111111111112000010111124

image image:tiles
position 129 126
