2121212121212121212113313131313131311421
2121212121212121211332030102020200023014
2121212121212121212203000103040000010220
2121212121212121212204030403030400040120
2121212121212121212201040304000203000020
2121212121212121212202030304040304030020
2121212121212121212312020300020102001024
2121212121212121212123120300010100102421
2121212121212121212121231200040110242121
2121212121212121212121212200010120212121
2121212121212121212121212203010320212121

image image:tiles
position 129 126
sprite @14,3 sprite:sign (u16)0 (u8:cipher)playfair (u8)14
