2121212121212121212121212200000020212121
31313131310a0b31310c0d313200000020212121
00000000001a1b00001c1d000000000020212121
1200000000000000000000000000000020212121
2200000000000000000000000000000020212121
2200000000000000000000000000000020212121
2311120000000010120000000000000020212121
2121220000000030320000001011111124212121
2121220000000000000000002021212121212121
2121220000000000000000002021212121212121
2121231111111111111111112421212121212121

image image:tiles
position 129 127
sprite @6,5 sprite:skeleton (u16)0 (u8:cipher)playfair (u8)18
sprite @11,4 sprite:firepot (u32)0
