1331313131313131313131313132000030313114
3200000000000000000000000000000000000020
0000000000000000000000000000000000000020
1200000000000000000000000000000000000020
2200000000000000000000000000000000000020
2200000000000000000000000000000000000020
2200000000000000000000000000000000000020
2200000000000000000000000000000000000020
2200000000000000000000000000000000000020
2200000000000000000000000000000000000020
2311111111111111111111111111111111111124

image image:tiles
position 129 127 0
