2121212121212121212121212200030120212121
31313131310a0b31310c0d313203010020212121
02040204031a1b03011c1d010302020320212121
1201020100000403030102010202010120212121
2201030303030104030100020402010220212121
2200040301010000030301030403030220212121
2311120001040310120301020200010020212121
2121220003000330320101041011111124212121
2121220300030401020002042021212121212121
2121220302010404010402002021212121212121
2121231111111111111111112421212121212121

image image:tiles
position 129 127
sprite @6,5 sprite:skeleton (u16)0 (u8:cipher)playfair (u8)18
sprite @11,4 sprite:firepot (u32)0
