1331313131313131313131313131313131313114
2200000000000000000000000000000000000020
2200003400000000000033000000000000000020
2200333334001012001012001012000000000020
2200003300003032003032003032000000000020
2200000000000000000000000000000000000020
2200000000000000000000000000000000000020
3200000000000000000000000000000000000020
0000000000000000000000000000000000000020
0000000000000000000000000000000000000020
1111111111111111111111111111111111111124

image image:tiles
position 129 128
