1331313131313131313131313131313131313114
3200000000000000000000000000000000000020
0000000000000000000000000000000000000020
0000000000000000000000001011111112000020
1111111111111111111200002021212122000020
2113313131313131142200002021212122000020
2122000000000000202200003031313132000020
2122000000000000303200000000000000000030
2122000000000000000000000000000000000000
2122000000000000101200000000000000000000
2123111200001011242311120000001011111111

image image:tiles
position 127 128
sprite @9,8 sprite:gate (u8:flag)maze_exit (u8)1 (u16)0
sprite @3,7 sprite:switch (u8:flag)maze_exit (u24)0
sprite @5,7 sprite:sign (u16)0 (u8:cipher)substitution (u8)7
