1331313131313131313131313131313131313114
2200000000000000000000000000000000000020
2200000000000000000000000000000000000020
2200000000000000000000000000000000000020
3200000000000000000000000000000000000020
0000000000000000000000000000000000000020
0000000000000000000000000000000000000020
0000000000000000000000000000000000000030
1200000000000000000000000000000000000000
2200000000000000000000000000000000000000
2311111111120000001011111111111111111111

image image:tiles
position 127 128
