1331313131313131313131313131313131313114
3201000300040203030301010203020103030120
0100020201010401030204020402010402010320
0204010002000100020302011011111112040320
1111111111111111111203002021212122010020
2113313131313131142201012021212122030320
2122040202000201202200003031313132040220
2122010000040301303200040303030204040130
2122040202020404040400020402040202020404
2122040101020000101201010303030002030101
2123111202041011242311120003041011111111

image image:tiles
position 127 128
sprite @9,8 sprite:gate (u8:flag)maze_exit (u8)1 (u16)0
sprite @3,7 sprite:switch (u8:flag)maze_exit (u24)0
sprite @5,7 sprite:sign (u16)0 (u8:cipher)substitution (u8)7
